25 50
218 15 0 196 15 0 196 15 0 196 15 0 196 15 0 196 15 0 196 15 0 196 15 0 196 15 0 196 15 0 196 15 0 196 15 0 196 15 0 196 15 0 196 15 0 196 15 0 196 15 0 196 15 0 196 15 0 196 15 0 196 15 0 196 15 0 196 15 0 196 15 0 196 15 0 196 15 0 196 15 0 196 15 0 196 15 0 196 15 0 196 15 0 196 15 0 196 15 0 196 15 0 196 15 0 196 15 0 196 15 0 196 15 0 196 15 0 196 15 0 196 15 0 196 15 0 196 15 0 196 15 0 196 15 0 196 15 0 196 15 0 196 15 0 196 15 0 191 15 0 
179 15 0 42 3 0 42 3 0 42 3 0 42 3 0 42 3 0 42 3 0 42 3 0 32 15 0 218 15 0 196 15 0 191 15 0 32 15 0 42 3 0 42 3 0 42 3 0 42 3 0 42 3 0 42 3 0 32 15 0 218 15 0 196 15 0 196 15 0 196 15 0 196 15 0 196 15 0 196 15 0 196 15 0 196 15 0 196 15 0 196 15 0 196 15 0 196 15 0 196 15 0 196 15 0 196 15 0 196 15 0 196 15 0 196 15 0 191 15 0 42 3 0 42 3 0 42 3 0 42 3 0 42 3 0 42 3 0 42 3 0 42 3 0 42 3 0 179 15 0 
179 15 0 42 3 0 42 3 0 42 3 0 42 3 0 42 3 0 42 3 0 42 3 0 42 3 0 179 15 0 32 15 0 179 15 0 32 15 0 42 3 0 42 3 0 42 3 0 42 3 0 42 3 0 42 3 0 32 15 0 179 15 0 32 15 0 32 15 0 32 15 0 32 15 0 32 15 0 32 15 0 32 15 0 32 15 0 32 15 0 32 15 0 32 15 0 32 15 0 32 15 0 32 15 0 32 15 0 32 15 0 32 15 0 32 15 0 179 15 0 42 3 0 42 3 0 42 3 0 42 3 0 42 3 0 42 3 0 42 3 0 42 3 0 42 3 0 179 15 0 
192 15 0 196 15 0 196 15 0 196 15 0 196 15 0 196 15 0 196 15 0 196 15 0 196 15 0 217 15 0 32 3 0 192 15 0 196 15 0 196 15 0 196 15 0 196 15 0 196 15 0 196 15 0 196 15 0 196 15 0 217 15 0 32 15 0 196 15 0 196 15 0 196 15 0 196 15 0 196 15 0 196 15 0 194 15 0 196 15 0 196 15 0 196 15 0 196 15 0 196 15 0 196 15 0 191 15 0 32 15 0 218 15 0 196 15 0 217 15 0 42 3 0 42 3 0 42 3 0 42 3 0 42 3 0 42 3 0 42 3 0 42 3 0 32 15 0 179 15 0 
32 3 0 32 3 0 32 3 0 32 3 0 32 3 0 32 3 0 32 15 0 32 15 0 32 15 0 32 15 0 32 3 0 32 15 0 32 15 0 32 15 0 32 15 0 32 15 0 32 15 0 32 15 0 32 15 0 32 15 0 32 15 0 32 15 0 32 15 0 32 15 0 32 15 0 32 15 0 32 15 0 32 15 0 179 15 0 42 3 0 32 15 0 218 15 0 196 15 0 196 15 0 196 15 0 217 15 0 32 15 0 179 15 0 42 3 0 42 3 0 42 3 0 42 3 0 218 15 0 196 15 0 191 15 0 42 3 0 42 3 0 42 3 0 32 15 0 179 15 0 
218 15 0 196 15 0 196 15 0 196 15 0 196 15 0 196 15 0 196 15 0 196 15 0 196 15 0 191 15 0 32 15 0 218 15 0 196 15 0 196 15 0 196 15 0 196 15 0 196 15 0 196 15 0 196 15 0 196 15 0 196 15 0 196 15 0 196 15 0 196 15 0 196 15 0 196 15 0 196 15 0 196 15 0 217 15 0 42 3 0 32 15 0 179 15 0 32 15 0 32 15 0 32 15 0 32 15 0 32 15 0 179 15 0 42 3 0 42 3 0 42 3 0 32 15 0 179 15 0 32 15 0 179 15 0 42 3 0 42 3 0 42 3 0 32 15 0 179 15 0 
179 15 0 42 3 0 42 3 0 42 3 0 42 3 0 42 3 0 42 3 0 42 3 0 32 15 0 179 15 0 32 15 0 192 15 0 196 15 0 196 15 0 196 15 0 196 15 0 196 15 0 196 15 0 196 15 0 196 15 0 196 15 0 196 15 0 196 15 0 196 15 0 196 15 0 196 15 0 196 15 0 191 15 0 32 15 0 42 3 0 32 15 0 179 15 0 32 15 0 218 15 0 196 15 0 196 15 0 196 15 0 217 15 0 42 3 0 42 3 0 42 3 0 32 15 0 179 15 0 32 15 0 179 15 0 32 15 0 42 3 0 42 3 0 42 3 0 179 15 0 
179 15 0 42 3 0 42 3 0 42 3 0 218 15 0 196 15 0 191 15 0 32 15 0 42 3 0 179 15 0 32 15 0 32 15 0 32 15 0 32 15 0 32 15 0 32 15 0 32 15 0 32 15 0 32 15 0 32 15 0 32 15 0 32 15 0 32 15 0 32 15 0 32 15 0 32 15 0 32 15 0 179 15 0 32 15 0 42 3 0 32 15 0 179 15 0 32 15 0 179 15 0 42 3 0 42 3 0 42 3 0 42 3 0 42 3 0 218 15 0 196 15 0 196 15 0 217 15 0 32 15 0 192 15 0 196 15 0 191 15 0 42 3 0 42 3 0 179 15 0 
179 15 0 42 3 0 42 3 0 42 3 0 179 15 0 32 15 0 179 15 0 32 15 0 42 3 0 192 15 0 196 15 0 196 15 0 196 15 0 196 15 0 196 15 0 196 15 0 191 15 0 32 15 0 218 15 0 196 15 0 196 15 0 196 15 0 196 15 0 196 15 0 196 15 0 191 15 0 32 15 0 179 15 0 32 15 0 42 3 0 42 3 0 192 15 0 196 15 0 217 15 0 32 15 0 42 3 0 42 3 0 42 3 0 32 15 0 179 15 0 32 15 0 32 15 0 32 15 0 32 15 0 32 15 0 32 15 0 179 15 0 32 15 0 42 3 0 179 15 0 
179 15 0 42 3 0 42 3 0 42 3 0 179 15 0 32 15 0 179 15 0 32 15 0 42 3 0 42 3 0 42 3 0 42 3 0 42 3 0 42 3 0 42 3 0 42 3 0 179 15 0 32 15 0 179 15 0 42 3 0 32 15 0 42 3 0 42 3 0 42 3 0 32 15 0 179 15 0 32 15 0 192 15 0 196 15 0 196 15 0 196 15 0 196 15 0 196 15 0 196 15 0 196 15 0 191 15 0 32 15 0 42 3 0 32 15 0 179 15 0 32 15 0 218 15 0 196 15 0 196 15 0 196 15 0 196 15 0 217 15 0 42 3 0 42 3 0 179 15 0 
179 15 0 42 3 0 42 3 0 42 3 0 179 15 0 32 15 0 192 15 0 196 15 0 196 15 0 196 15 0 196 15 0 196 15 0 196 15 0 191 15 0 32 15 0 42 3 0 179 15 0 32 15 0 179 15 0 42 3 0 32 15 0 42 3 0 42 3 0 42 3 0 32 15 0 179 15 0 32 15 0 32 15 0 32 15 0 32 15 0 32 15 0 32 15 0 32 15 0 32 15 0 32 15 0 179 15 0 32 15 0 42 3 0 32 15 0 179 15 0 32 15 0 179 15 0 32 15 0 42 3 0 42 3 0 42 3 0 42 3 0 42 3 0 32 15 0 179 15 0 
179 15 0 42 3 0 42 3 0 42 3 0 179 15 0 32 15 0 32 15 0 32 15 0 32 15 0 32 15 0 32 15 0 32 15 0 32 15 0 179 15 0 32 15 0 42 3 0 179 15 0 32 15 0 179 15 0 42 3 0 32 15 0 42 3 0 42 3 0 42 3 0 32 15 0 192 15 0 196 15 0 196 15 0 196 15 0 196 15 0 196 15 0 196 15 0 196 15 0 196 15 0 196 15 0 217 15 0 32 15 0 42 3 0 32 15 0 179 15 0 32 15 0 192 15 0 196 15 0 196 15 0 196 15 0 191 15 0 42 3 0 42 3 0 42 3 0 179 15 0 
179 15 0 42 3 0 42 3 0 42 3 0 192 15 0 196 15 0 194 15 0 196 15 0 196 15 0 196 15 0 196 15 0 196 15 0 32 15 0 192 15 0 196 15 0 196 15 0 217 15 0 32 15 0 179 15 0 42 3 0 32 15 0 42 3 0 32 15 0 218 15 0 196 15 0 196 15 0 196 15 0 196 15 0 196 15 0 196 15 0 196 15 0 196 15 0 196 15 0 196 15 0 196 15 0 191 15 0 32 15 0 42 3 0 32 15 0 179 15 0 32 15 0 32 15 0 32 15 0 32 15 0 32 15 0 179 15 0 42 3 0 42 3 0 42 3 0 179 15 0 
179 15 0 42 3 0 42 3 0 42 3 0 42 3 0 42 3 0 179 15 0 32 15 0 32 15 0 32 15 0 32 15 0 32 15 0 32 15 0 32 15 0 32 15 0 32 15 0 32 15 0 32 15 0 179 15 0 42 3 0 32 15 0 42 3 0 32 15 0 179 15 0 32 15 0 32 15 0 32 15 0 32 15 0 32 15 0 32 15 0 32 15 0 32 15 0 32 15 0 32 15 0 32 15 0 179 15 0 32 15 0 42 3 0 42 3 0 192 15 0 196 15 0 196 15 0 196 15 0 191 15 0 32 15 0 179 15 0 42 3 0 42 3 0 42 3 0 179 15 0 
179 15 0 42 3 0 42 3 0 42 3 0 42 3 0 42 3 0 192 15 0 196 15 0 196 15 0 196 15 0 191 15 0 32 15 0 218 15 0 196 15 0 196 15 0 196 15 0 196 15 0 196 15 0 217 15 0 42 3 0 32 15 0 42 3 0 32 15 0 179 15 0 32 15 0 218 15 0 196 15 0 196 15 0 196 15 0 196 15 0 191 15 0 32 15 0 196 15 0 196 15 0 196 15 0 193 15 0 196 15 0 196 15 0 196 15 0 196 15 0 196 15 0 191 15 0 42 3 0 179 15 0 32 15 0 179 15 0 42 3 0 42 3 0 42 3 0 179 15 0 
179 15 0 42 3 0 42 3 0 42 3 0 42 3 0 42 3 0 42 3 0 42 3 0 42 3 0 32 15 0 179 15 0 32 15 0 179 15 0 32 15 0 42 3 0 42 3 0 42 3 0 42 3 0 42 3 0 42 3 0 42 3 0 42 3 0 32 15 0 179 15 0 32 15 0 179 15 0 32 15 0 42 3 0 42 3 0 32 15 0 179 15 0 32 15 0 32 15 0 32 15 0 32 15 0 32 15 0 32 15 0 32 15 0 32 15 0 32 15 0 32 15 0 179 15 0 42 3 0 179 15 0 32 15 0 179 15 0 42 3 0 42 3 0 42 3 0 179 15 0 
179 15 0 42 3 0 42 3 0 42 3 0 42 3 0 42 3 0 42 3 0 42 3 0 42 3 0 32 15 0 179 15 0 32 15 0 192 15 0 196 15 0 196 15 0 196 15 0 196 15 0 196 15 0 196 15 0 196 15 0 196 15 0 196 15 0 196 15 0 217 15 0 32 15 0 192 15 0 196 15 0 196 15 0 196 15 0 194 15 0 193 15 0 196 15 0 196 15 0 196 15 0 196 15 0 196 15 0 196 15 0 194 15 0 196 15 0 196 15 0 196 15 0 193 15 0 196 15 0 217 15 0 32 15 0 192 15 0 196 15 0 191 15 0 42 3 0 179 15 0 
179 15 0 42 3 0 42 3 0 42 3 0 42 3 0 42 3 0 42 3 0 42 3 0 42 3 0 32 15 0 179 15 0 32 15 0 32 15 0 32 15 0 32 15 0 32 15 0 32 15 0 32 15 0 32 15 0 32 15 0 32 15 0 32 15 0 32 15 0 32 15 0 32 15 0 32 15 0 32 15 0 32 15 0 32 15 0 179 15 0 42 3 0 42 3 0 42 3 0 42 3 0 42 3 0 42 3 0 42 3 0 179 15 0 32 15 0 32 15 0 32 15 0 32 15 0 32 15 0 32 15 0 32 15 0 32 15 0 32 15 0 179 15 0 42 3 0 179 15 0 
179 15 0 42 3 0 42 3 0 42 3 0 42 3 0 42 3 0 42 3 0 42 3 0 42 3 0 32 15 0 192 15 0 196 15 0 196 15 0 196 15 0 196 15 0 196 15 0 196 15 0 196 15 0 196 15 0 191 15 0 32 15 0 218 15 0 196 15 0 196 15 0 196 15 0 196 15 0 196 15 0 194 15 0 196 15 0 193 15 0 196 15 0 196 15 0 196 15 0 196 15 0 196 15 0 196 15 0 196 15 0 217 15 0 32 15 0 196 15 0 196 15 0 196 15 0 194 15 0 196 15 0 196 15 0 196 15 0 196 15 0 217 15 0 42 3 0 179 15 0 
179 15 0 42 3 0 42 3 0 42 3 0 42 3 0 42 3 0 42 3 0 42 3 0 42 3 0 218 15 0 196 15 0 196 15 0 196 15 0 196 15 0 196 15 0 196 15 0 196 15 0 196 15 0 196 15 0 217 15 0 32 15 0 179 15 0 32 15 0 42 3 0 42 3 0 42 3 0 32 15 0 179 15 0 32 15 0 32 15 0 32 15 0 32 15 0 32 15 0 32 15 0 32 15 0 32 15 0 32 15 0 32 15 0 32 15 0 32 15 0 32 15 0 32 15 0 179 15 0 42 3 0 42 3 0 42 3 0 42 3 0 42 3 0 42 3 0 179 15 0 
179 15 0 42 3 0 42 3 0 42 3 0 42 3 0 42 3 0 42 3 0 42 3 0 42 3 0 179 15 0 32 15 0 32 15 0 32 15 0 32 15 0 32 15 0 32 15 0 32 15 0 32 15 0 32 15 0 32 15 0 32 15 0 179 15 0 32 15 0 42 3 0 42 3 0 42 3 0 32 15 0 179 15 0 32 15 0 218 15 0 196 15 0 196 15 0 196 15 0 196 15 0 196 15 0 196 15 0 196 15 0 191 15 0 32 15 0 218 15 0 196 15 0 196 15 0 217 15 0 32 15 0 42 3 0 42 3 0 42 3 0 42 3 0 42 3 0 179 15 0 
179 15 0 42 3 0 42 3 0 42 3 0 42 3 0 42 3 0 42 3 0 42 3 0 42 3 0 192 15 0 196 15 0 196 15 0 196 15 0 191 15 0 32 15 0 196 15 0 196 15 0 196 15 0 196 15 0 196 15 0 196 15 0 193 15 0 196 15 0 196 15 0 196 15 0 196 15 0 196 15 0 217 15 0 32 15 0 192 15 0 196 15 0 196 15 0 196 15 0 196 15 0 196 15 0 191 15 0 42 3 0 179 15 0 32 15 0 192 15 0 196 15 0 196 15 0 196 15 0 196 15 0 196 15 0 196 15 0 191 15 0 42 3 0 42 3 0 179 15 0 
179 15 0 42 3 0 42 3 0 42 3 0 42 3 0 42 3 0 42 3 0 42 3 0 42 3 0 42 3 0 42 3 0 42 3 0 32 15 0 179 15 0 32 15 0 32 15 0 32 15 0 32 15 0 32 15 0 32 15 0 32 15 0 32 15 0 32 15 0 32 15 0 32 15 0 32 15 0 32 15 0 32 15 0 32 15 0 32 15 0 32 15 0 32 15 0 32 15 0 32 15 0 32 15 0 179 15 0 42 3 0 179 15 0 32 15 0 32 15 0 32 15 0 32 15 0 32 15 0 32 15 0 32 15 0 32 15 0 192 15 0 196 15 0 196 15 0 217 15 0 
179 15 0 42 3 0 42 3 0 42 3 0 42 3 0 42 3 0 42 3 0 42 3 0 42 3 0 42 3 0 42 3 0 42 3 0 42 3 0 192 15 0 196 15 0 196 15 0 196 15 0 196 15 0 196 15 0 196 15 0 196 15 0 196 15 0 196 15 0 196 15 0 196 15 0 196 15 0 196 15 0 196 15 0 196 15 0 196 15 0 196 15 0 196 15 0 196 15 0 196 15 0 196 15 0 217 15 0 42 3 0 192 15 0 196 15 0 196 15 0 196 15 0 196 15 0 196 15 0 196 15 0 191 15 0 32 15 0 32 15 0 32 15 0 32 15 0 32 15 0 
192 15 0 196 15 0 196 15 0 196 15 0 196 15 0 196 15 0 196 15 0 196 15 0 196 15 0 196 15 0 196 15 0 196 15 0 196 15 0 196 15 0 196 15 0 196 15 0 196 15 0 196 15 0 196 15 0 196 15 0 196 15 0 196 15 0 196 15 0 196 15 0 196 15 0 196 15 0 196 15 0 196 15 0 196 15 0 196 15 0 196 15 0 196 15 0 196 15 0 196 15 0 196 15 0 196 15 0 196 15 0 196 15 0 196 15 0 196 15 0 196 15 0 196 15 0 196 15 0 196 15 0 193 15 0 196 15 0 196 15 0 196 15 0 196 15 0 217 15 0 
